1110111
1M00001
10111M1
001M001
10111M1
1M00001
1110111