1110101
1000001
1011101
000M001
1011111
1000M01
1110001