111111111111111111111
1100000000000100000P1
100000000110000000001
100000000001000000001
10M001000000000000101
10M0011001000000M0001
11010M000100000M01001
10M000010001M00000001
100000100M01000000001
1M0000000M0000M000001
1100110000000M00M0001
1000100000100001M0001
10000M0000010001M0001
100100010000000010001
100M0M00M000101000101
110000010M00001000101
10000000000100001M001
1000M00000000000M0001
1MM0000000MM000100001
10M001000000000000001
1111111111111E1111111
