111111111111111111111
1000000000000000001P1
100000000MM00M00000M1
100110000M1011M0001M1
100000000001000010101
10000000M0M0001000001
1001000000000000000M1
101010000010100001001
100001M00000000M00001
10M000100000010001001
1000M000M000M0110M001
100100000000100001001
1M010000M000000M000M1
10000000M000000000001
1M0000101001000000001
1000000M0000000M10001
100000100001100000001
100M00000M000M0000101
1000000000000M1010001
10000M000000000000M01
1111111111111E1111111
