111111111111111111111
1000000001000101110P1
100001000000000M00001
10M0000000001100M0001
100100000M01001M00001
10000000000M100000001
100000010000000000001
10000001000000000M001
100000010000000001001
100000100M00100010001
1000M0001100000000001
111000001000001000001
1100000000M10000000M1
100100000000000000001
11101000000M0M000M001
1M00100000000M1000001
100000000010000000001
100000000M000000M0001
100000000M00001010001
100000000000001000001
1111111111111E1111111
