111111111111111111111
100001101000000M100P1
1000000010000000M0001
100M000M0000000000001
100M00000M01100001001
1000000000000000100M1
1000000000000000M0101
1000011M000M000000001
100000M00000M100M00M1
101M01001M00000000001
10000011M000000000001
1000000000M000000M001
10000000000M000100001
110001000010001001001
1100000010000100M0M01
1M000000100001M0M0001
1100010M00M00MM000101
10M0000000010000M0001
1110M0000000000000001
100000000000000000001
1111111111111E1111111
