111111111111111111111
1000000000000M00000P1
100010010000M00010001
110000000000000M00001
100001000000010000M01
100101000M10101000001
100001000000000010001
10000000000M000000001
100001000000M1M000001
11M001100M01000001001
100010M000000000010M1
10M0M000000M000001M01
100000000100000000001
100001000100000100001
1000100000000M0000M01
100000000100100000001
110000M00100010001001
100000M00000000000001
100000001000M101M0101
100100000000010000001
1111111111111E1111111
