111111111111111111111
100000000M0M0000100P1
100001000000000000101
100000010100100010001
10000000M00M000100101
1000010000000M0100001
10000000000M001000001
100010010100100000001
100100010000010000001
101M1000M01000000M101
100000010000000000001
100100000001M00000001
10010000000000M0000M1
1000M01000M000M101001
110100M00000M000M1001
10000100M000M00000001
1M000MM00000000010001
1000M0000100000000101
100000110000010000001
100001000000000000001
1111111111111E1111111
