111111111111111111111
1001001000000000010P1
100000M00M0100M0M0001
100M00MM0000100000001
10M00M000000M00000001
1100000M0001000000001
1000M0000M000M0000001
100000100000001000001
1M0M10MM0010000000101
110000000000000000101
10M00000000010M000001
10000000000M000101101
1011M0000010000000001
1M001000M00M00000M101
100000M00001000011001
1001M0000000M000M0001
10000000000M000M10M01
100M000000000100000M1
100000000000000000001
1000000000000M0000M01
1111111111111E1111111
