111111111111111111111
1010000011000010000P1
100100000101000000M01
1001M00M0000000M00001
101101000000001100001
10000M001000000000001
100000MM000000000M001
10100000M000M0000M101
100MM00000000010000M1
10101M000000001001001
100000010000000000001
100001000000000000001
101M0M01M001000100M01
100000001000000000001
100001M0000M000001001
100100101100M00000001
100000010000010M00001
10100001000001000M001
110000001000000100001
100M0010000000M000001
1111111111111E1111111
