111111111111111111111
1MM00000000100000M0P1
100000010000000011001
11000000010000M000101
1000001M00M0000000001
1000M00000M0001000101
100000010010000000M01
100M000000000000000M1
100100000000100M00001
1001000000M0001011001
1000000000M0100000001
1M0001000M00000001001
100M00010000100000001
1M0M00100M0000000M001
110000M11110010010001
100000000000001010001
1000000M1001000001001
10M000000000000100001
10110M0000M0001000001
1M000001M000100001001
1111111111111E1111111
