111111111111111111111
1000000000100M00000P1
1000M0000000000001001
1000M100000000100MM01
100000000M00000M00001
100000001M001M0000M01
100M010M000M000000001
100100000010000M00101
1001000011000100000M1
1000M000000000000M001
1000000000M0000000001
110000000000000M10001
1100M0010M0MM10000101
10000000100M000000001
1000000000MM0M00000M1
10000M0000000M0001001
1000MMM01000000000001
100001MM0000000000101
100000000000000000001
100000000010000M00001
1111111111111E1111111
