111111111111111111111
1000000M10001001M00P1
10M000000000000M00001
1000000000M0M00M00001
1MMM00000000M10M00M01
10100M000M00000100M01
1000M0010000000000001
1000000100M0010M00001
10100M0M0000001000001
1M000000M000000000001
1000000M1000000010001
1000M00M10M1000000001
10000000000000000M001
100001M010001M0000001
1110001000001M0000001
101M0000M010100000001
1000M00000000000M1001
100000100000000000001
100001000000001000M01
10M00000000M0M00001M1
1111111111111E1111111
