111111111111111111111
1000M0000000000M000P1
100010001000M001M0001
10MMM00M10M0000000001
100M01001010M01100101
101000M00000000000001
1M0000000011010000001
10000000M000000000001
10000M00110M10M0M0001
10M101100000000001001
1M100M000100000000001
1001000000000000MM001
10000001000M000000001
10001M100100000000001
10M00000000M000100001
1000M0000000000000001
101000000000110100M01
10011000000M101000001
10001000M000100000001
1010000M0000000000001
1111111111111E1111111
