111111111111111111111
1000001000M0M10000MP1
10010M00MM00M1000M001
100M1000M000010100001
1010000000M01000M0001
100000100M00100000001
100000001MM0M00000001
10101000M00MM10010001
100000000000100000101
110000001000000MM0001
11100010M100000000001
1001000M00000M00M0001
100010000000000000001
110000000MM00010M0101
1000000000000M0000001
1001000M0000000M00001
10M0M000000100M001001
1M00000M0000M10000101
1000M0100000010000M01
100M10001000000010001
1111111111111E1111111
