111111111111111111111
1M0000MM01M00000M00P1
10000000000001M000M01
1001M00001M0000010M01
100011000000001100001
1000M0001110100100001
100011000000000M00001
10MM00010M0000M000001
1100101M0000100000101
101001000000100000001
100100000000000001001
100000000100010001M01
100001000000000000101
100000000001010000001
10000100M100000000001
100001001100000000001
1100000000M0000000101
10000000M0M0000M00M01
10M0000100001M1000001
10000010000000M000001
1111111111111E1111111
