1110111
1M000M1
1011111
100M000
1011101
1M100M1
1110111