111111111111111111111
10000100000000000M0P1
1000001000000M0010M01
10000M000100001000001
101000101000000101001
100101000000000M10101
111100000000000000M01
100000000000001000001
10010M000000000000001
100000000M0M010000M01
100000000000010000101
100000000000000000001
1M0000000000M10001001
100M0010M000000000001
100M00000000000001001
100000000000000000001
1001000M0000000000001
100000100000000000001
10000M0001000M0M00001
10000M10M100M0M000001
1111111111111E1111111
