133333333333333333332
1000000M000M0000000E2
1M3333333333333333332
100000000000000000002
10000000000000M000002
100000000000000000002
1000000M0000M00000002
100000000000000000002
133333333003333333332
100000000000000000002
1M0000000000000000002
1000000000000M0000002
100000000000000000002
100000000M00000000002
100M00000000000000M02
100000000000000000002
100000M000000M0000002
133333333000000000002
1000000000000000M0002
10P000000000000000002
533333333333333333334