111111111111111111111
10M0000001M1000000001
1M0010000101000000001
100100000101000000001
101000000101000000001
10000P000M0M000000001
100000000000000000001
100000000101000000001
100000000101000110111
1000000111M11101101M1
100000000M0M000000001
1000000111M11101101M1
100000000101000110111
100000000101000000001
100000000000000001001
1M0100000111000M01001
1000100000M0000001001
100101001001M11111001
1000M001M100100000M0E
100000000000000000001
111111111111111111111
