999999999132999999999
9999999991P2999999999
999999999102999999999
999999999102999999999
999999999102999999999
999999999102999999999
999999999102999999999
133333333303333333334
100000000000000000002
100000000000000000002
100000000000000000002
1000000000D0000000002
100000000000000000002
100000000000000000002
133333333706333333332
999999999102999999999
999999999102999999999
999999999102999999999
999999999102999999999
9999999991E2999999999
999999999132999999999