111111111111111111111
1P0000000000000010001
10000000000000010M101
100000000000001001M01
100000000000000M10011
1000000000000001M0101
100000000000000001001
100000111100001110101
111101000010M01000001
1000M1M00001001011101
10M00100100010000M001
1011110001M0101011111
100001MM0011001000M01
100M00000000001110001
100000011101110000001
10000001M000M10001001
1000000100000100M1M01
100000000101000111101
1000000101010100M1M01
1000000101M1010000001
1111111111111111111E1