111111111111111111111
1P00000100M00100M0001
101111001000101101101
101000000101001101101
1010100000000000M00M1
101000M000M0001101101
10000M000000001101101
100000000000001110111
101111001111101M00001
10MMM00011101010111M1
1011M000100010001M001
10MMM00001000010111M1
101111001111101M00001
100000000000001110111
1000000M00000M0001001
1M0100001111100M01001
100010001M0M100001001
100101001010101111001
1000M0001010100000M0E
1000000000M0000000001
111111111111111111111