111111111111111111111
100000000000000000001
101111111111111111101
101000000000000000101
101000200000002000101
10000000000000000010E
1110000M0000000000111
111000000000000000111
111111111101111111111
100000011000110000011
100000000000000010001
111111111111111110001
100000000000000010001
100000000M00000000001
111011111111111111111
100011100100001000001
101111100000000000001
100000000100001000001
111111111111111111101
10000000000000000P001
111111111111111111111