1111111
1000001
1010101
0M1M1M0
1011101
100M001
1110111