111111111111111111111
100000010000010000001
100P01M10101010000001
10000100M1M1M00000001
100000110111010000001
1011100100M0010000001
10M000M11101110000001
111011111101110000001
1M000M11M0M0M10000001
101111110010010000001
100M0000M0M1M00000001
101110110010010000001
1M100M11M0M0M10000001
111011111101110000001
100000100000000000001
100001000111000000001
1011100000M0000000001
100M10001001M10000001
10001001M100100000001
10000000000000000000E
111111111111111111111
