111111111111111111111
100000000000000000001
101111111111111111101
101000000000000000101
101000222222222000101
10000000000000000010E
111000000000000000111
1110000000M0000000111
111111111101111111111
100000011000110000011
100000000000000010001
100000000000000000001
100000000MMMMM0010001
100000000M000M0000001
111011111111111111111
100000000101001000001
100000000001000000001
100000000100001000001
111111111101111111111
10000000000000000P001
111111111111111111111