133333333329999999999
1000P0000029999999999
100000000029999999999
133333300029999999999
100000000M33333333332
100000000000000000002
133330000M0M000000002
100000000000000000002
133333300003333333334
100000000000002999999
100000000000002999999
133333003333332999999
100000000000002999999
100000000M000M3333332
133000000000000000002
100000000000000000002
100000MM0000000000002
10000000000000MM00002
133333333333333333302
1E000000M000000000002
533333333333333333334