111111111111111111111
1P00000100000100M0001
100000010101011101101
10000000M1M1M01101101
1000000101110100M00M1
1000000100M0011101101
100000011101111101101
100000000001001110101
101111001000011000001
10MMM0000100001011101
1011M000001100000M001
10MMM0000000101011111
101111000111001000M01
100000000000001110001
1000001M00000M0001001
100001001111100M01001
101110001M0M100001001
100M10001010101111001
100010001010100000M0E
1000000000M0000000001
111111111111111111111
