133333333333333333332
10000000M00000MMM0002
103333333333333333332
100000000000000000002
100000000D0000M000002
100000000000000000002
1000000M0000M00000002
100000000000000000002
133333003300330033332
100000000000000000002
1M0000000000M00000002
100000000000000000002
100000000000000000002
100M0000M000000000002
100000000000000000M02
100000000000000000002
100000M000000M0000002
100000000000000000002
10000M000000000000002
1000000000000000P0002
133333333333333333332