111111111111111111111
1000000001M10000M0001
100P01M00101001101101
100001000101001101101
1000001001010000M00M1
101110000M0M001101101
10M000M00000001101101
100000011101111110111
101111010000011M00001
10MMM00101M10110111M1
1011M0000M0M00001M001
10MMM00101M10110111M1
101111010000011M00001
100000011101111110111
100000011101110001001
10000001M000M10M01001
100000010000010001001
100000000101001111001
100000010101010000M0E
1000000101M1010000001
111111111111111111111