111111111111111111111
10000000M00000MMM0001
101111111111111111101
101000000000000000101
101000000D0000M000101
10000000000000000010E
1110000M0000M00000111
111000000000000000111
111111111101111111111
100000000000000000011
1M0000000000M00010001
100000000000000000001
100000001000000000001
100M00001M00000000001
100000001000000000M01
100000001000000000001
100000M010000M0000001
111111111000000011011
10000M000000000010001
10000000000000001P001
111111111111111111111