111111111111111111111
100001000000000M000P1
100000100000000010001
100000000100001000001
101000101000000101001
100101000000000010101
111100000000000000001
100000000000001000001
100100000000000000001
100000000000010000001
100000000000010000101
100000000000000000001
100000000000010001001
100000100000000000001
100000000000000001001
100000000000000000001
100100000000000000001
100000100000000000001
100000000100M00000001
100000100100000000001
1111111111111E1111111
