111111111111111111111
10M000000000000000001
1M0010001M01100000001
10010000011M000000001
101000000110000000001
10000P001001100000001
100000000000000000001
100000100101000000001
111101000101000110111
1000M1M111M11101101M1
10M001000M0M000000001
1011110111M11101101M1
100001M00101000110111
100M00000101000000001
100000011101110000001
10000001M000M10001001
1000000100000100M1M01
100000000101000111101
1000000101010100M1M01
1000000101M1010000001
1111111111111111111E1