111111111111111111111
10M0000100M0010000001
1M0010001000100000001
100100000101000000001
101000000000000000001
10000P0000M0000000001
100000000000000000001
1000000000M0000000001
100000001000100110111
1000000000000001101M1
100000000101000000001
10000000M000M001101M1
100000000000000110111
100000001001000000001
100000100000000000001
100001000111000010101
1011100000M0000111M01
100M10001001M1001M00E
10001001M1001001M0001
100000000000000000001
111111111111111111111