1110111
1M0M0M1
1001001
0M0M1M0
1001001
1M0M0M1
1110111