1110111
1000001
101M101
00M0M00
101M101
1000001
1110111