1110111
11M0M11
1M101M1
0000000
1M101M1
11M0M11
1110111