1110111
1M000M1
1000001
0010100
1010101
101M101
1111111